13 16
5 9

12 6
****************
*     * *    * *
* ***** * **   *
* * *   *    * *
* * *** * **** *
*   *   *S*    *
*** * * * * *  *
*     * * *    *
******* * * *  *
*         *    *
* ** ****** *  *
*    *         *
******E*********