13 17
3 7

12 12
*****************
*               *
* * * * * * * * *
*      S        *
* * * * * * * * *
*               *
* * * * * * * * *
*               *
* * * * * * * * *
*               *
* * * * * * * * *
*               *
************E****